Year,NOC,Bronze,Gold,Silver,Total
1896,AUS,1,2,0,3
1896,AUT,2,2,1,5
1896,DEN,3,1,2,6
1896,FRA,2,5,4,11
1896,GBR,3,3,3,9
1896,GER,2,25,5,32
1896,GRE,20,10,18,48
1896,HUN,3,2,1,6
1896,SUI,0,1,2,3
1896,USA,2,11,7,20
1900,AUS,3,3,0,6
1900,AUT,3,0,3,6
1900,BEL,13,6,24,43
1900,BOH,2,0,1,3
1900,CAN,1,1,0,2
1900,COL,0,0,1,1
1900,CUB,0,1,1,2
1900,DEN,2,4,3,9
1900,ESP,0,2,0,2
1900,FRA,82,52,101,235
1900,GBR,15,59,34,108
1900,GER,11,14,20,45
1900,HAI,0,1,0,1
1900,HUN,2,1,2,5
1900,IND,0,0,2,2
1900,ITA,0,3,2,5
1900,LUX,0,1,0,1
1900,MEX,3,0,0,3
1900,NED,16,3,8,27
1900,NOR,3,0,6,9
1900,NZL,0,1,0,1
1900,SUI,1,16,4,21
1900,SWE,1,3,0,4
1900,USA,17,30,16,63
1904,AUS,1,0,3,4
1904,AUT,1,2,1,4
1904,CAN,12,27,9,48
1904,CUB,0,5,0,5
1904,FRA,0,0,2,2
1904,GBR,0,1,1,2
1904,GER,7,4,5,16
1904,GRE,1,1,0,2
1904,HUN,1,2,1,4
1904,NOR,0,2,0,2
1904,SUI,2,1,0,3
1904,USA,125,128,141,394
1906,AUS,3,0,0,3
1906,AUT,3,3,3,9
1906,BEL,6,2,3,11
1906,BOH,3,0,0,3
1906,CAN,0,1,1,2
1906,DEN,1,14,19,34
1906,FIN,1,2,1,4
1906,FRA,28,20,16,64
1906,GBR,8,9,22,39
1906,GER,6,14,10,30
1906,GRE,30,24,48,102
1906,HUN,3,5,5,13
1906,ITA,27,21,8,56
1906,NED,5,0,1,6
1906,NOR,0,20,5,25
1906,SUI,1,8,3,12
1906,SWE,14,2,5,21
1906,USA,6,12,6,24
1908,ANZ,2,15,2,19
1908,AUT,1,0,0,1
1908,BEL,8,1,24,33
1908,BOH,6,0,0,6
1908,CAN,30,14,8,52
1908,DEN,3,0,14,17
1908,FIN,28,1,1,30
1908,FRA,23,12,5,40
1908,GBR,90,147,131,368
1908,GER,6,4,11,21
1908,GRE,1,0,3,4
1908,HUN,6,7,7,20
1908,ITA,0,2,6,8
1908,NED,16,0,0,16
1908,NOR,3,7,32,42
1908,RSA,0,1,1,2
1908,RUS,0,1,2,3
1908,SWE,18,48,18,84
1908,USA,15,34,16,65
1912,ANZ,3,5,2,10
1912,AUT,5,0,9,14
1912,BEL,11,7,1,19
1912,CAN,3,3,2,8
1912,DEN,33,5,49,87
1912,FIN,22,9,40,71
1912,FRA,5,10,11,26
1912,GBR,59,47,64,170
1912,GER,23,11,19,53
1912,GRE,1,1,0,2
1912,HUN,3,10,17,30
1912,ITA,2,22,1,25
1912,NED,26,0,0,26
1912,NOR,34,40,6,80
1912,RSA,0,5,2,7
1912,RUS,9,0,5,14
1912,SUI,0,2,0,2
1912,SWE,25,103,62,190
1912,USA,36,46,25,107
1920,AUS,1,0,6,7
1920,BEL,66,57,65,188
1920,BRA,5,1,1,7
1920,CAN,3,10,3,16
1920,DEN,1,26,44,71
1920,ESP,0,0,23,23
1920,EST,0,1,2,3
1920,FIN,17,21,14,52
1920,FRA,57,13,71,141
1920,GBR,17,52,42,111
1920,GRE,0,0,5,5
1920,ITA,8,67,9,84
1920,JPN,0,0,3,3
1920,LUX,0,0,1,1
1920,NED,25,15,10,50
1920,NOR,27,58,52,137
1920,NZL,1,0,0,1
1920,RSA,6,3,12,21
1920,SUI,21,6,2,29
1920,SWE,64,52,38,154
1920,TCH,10,0,0,10
1920,USA,38,111,45,194
1924,ARG,2,5,3,10
1924,AUS,2,4,5,11
1924,AUT,1,3,4,8
1924,BEL,11,3,30,44
1924,CAN,1,9,19,29
1924,DEN,3,2,9,14
1924,EST,4,1,1,6
1924,FIN,18,28,21,67
1924,FRA,32,37,51,120
1924,GBR,30,31,34,95
1924,GRE,0,1,0,1
1924,HAI,5,0,0,5
1924,HUN,8,2,12,22
1924,IND,0,7,0,7
1924,IRL,1,0,1,2
1924,ITA,21,25,5,51
1924,JPN,1,0,0,1
1924,LUX,0,1,1,2
1924,MON,1,0,0,1
1924,NED,18,8,1,27
1924,NEP,0,1,0,1
1924,NOR,9,18,12,39
1924,NZL,1,0,0,1
1924,POL,1,0,4,5
1924,POR,4,0,0,4
1924,ROU,16,0,0,16
1924,RSA,1,1,1,3
1924,SUI,22,22,25,69
1924,SWE,43,8,30,81
1924,TCH,5,1,4,10
1924,URU,0,14,0,14
1924,USA,50,98,46,194
1924,YUG,0,2,0,2
1928,ARG,5,3,18,26
1928,AUS,1,1,2,4
1928,AUT,4,3,4,11
1928,BEL,5,0,1,6
1928,CAN,21,19,5,45
1928,CHI,0,0,1,1
1928,DEN,4,6,5,15
1928,EGY,1,2,1,4
1928,ESP,0,3,0,3
1928,EST,6,2,1,9
1928,FIN,10,10,9,29
1928,FRA,14,14,24,52
1928,GBR,25,7,27,59
1928,GER,46,21,15,82
1928,HAI,0,0,1,1
1928,HUN,0,10,11,21
1928,IND,0,14,0,14
1928,IRL,0,1,0,1
1928,ITA,26,24,22,72
1928,JPN,1,2,6,9
1928,LUX,0,1,0,1
1928,NED,8,20,29,57
1928,NOR,6,10,8,24
1928,NZL,0,1,0,1
1928,PHI,1,0,0,1
1928,POL,15,2,3,20
1928,POR,6,0,0,6
1928,RSA,5,1,0,6
1928,SUI,16,16,10,42
1928,SWE,23,9,21,53
1928,TCH,3,2,12,17
1928,URU,0,17,0,17
1928,USA,19,53,30,102
1928,YUG,10,1,1,12
1932,ARG,0,3,1,4
1932,AUS,1,3,1,5
1932,AUT,3,2,2,7
1932,BEL,1,0,0,1
1932,CAN,29,16,14,59
1932,DEN,4,0,7,11
1932,ESP,1,0,0,1
1932,FIN,17,6,9,32
1932,FRA,6,28,8,42
1932,GBR,14,9,12,35
1932,GER,21,10,26,57
1932,HUN,10,20,5,35
1932,IND,0,15,0,15
1932,IRL,0,2,0,2
1932,ITA,18,21,38,77
1932,JPN,4,10,17,31
1932,LAT,0,0,1,1
1932,MEX,0,0,2,2
1932,NED,1,2,10,13
1932,NOR,3,3,4,10
1932,NZL,0,0,2,2
1932,PHI,3,0,0,3
1932,POL,14,3,4,21
1932,RSA,3,2,0,5
1932,SUI,0,0,3,3
1932,SWE,12,14,9,35
1932,TCH,2,1,3,6
1932,URU,1,0,0,1
1932,USA,64,91,68,223
1936,ARG,4,5,2,11
1936,AUS,1,0,0,1
1936,AUT,9,7,44,60
1936,BEL,14,0,0,14
1936,CAN,9,1,25,35
1936,DEN,3,0,3,6
1936,EGY,2,2,1,5
1936,EST,3,2,2,7
1936,FIN,16,12,8,36
1936,FRA,19,13,13,45
1936,GBR,12,24,17,53
1936,GER,61,97,73,231
1936,HUN,17,25,1,43
1936,IND,0,19,0,19
1936,ITA,5,37,34,76
1936,JPN,10,9,4,23
1936,LAT,1,0,1,2
1936,MEX,16,0,0,16
1936,NED,21,9,7,37
1936,NOR,18,8,20,46
1936,NZL,0,1,0,1
1936,PHI,1,0,0,1
1936,POL,6,0,6,12
1936,POR,3,0,0,3
1936,ROU,0,0,1,1
1936,RSA,0,0,1,1
1936,SUI,24,9,29,62
1936,SWE,23,9,13,45
1936,TCH,1,5,12,18
1936,TUR,1,1,0,2
1936,USA,30,53,29,112
1936,YUG,0,0,1,1
1948,ARG,1,3,7,11
1948,AUS,5,2,9,16
1948,AUT,8,3,5,16
1948,BEL,8,7,6,21
1948,BRA,10,0,0,10
1948,CAN,7,13,2,22
1948,CUB,0,0,2,2
1948,DEN,27,7,17,51
1948,EGY,1,2,2,5
1948,ESP,0,0,3,3
1948,FIN,10,18,14,42
1948,FRA,26,28,23,77
1948,GBR,14,7,42,63
1948,HUN,22,15,27,64
1948,IND,0,20,0,20
1948,IRI,1,0,0,1
1948,IRL,1,0,0,1
1948,ITA,14,22,32,68
1948,JAM,0,1,2,3
1948,KOR,2,0,0,2
1948,MEX,4,4,1,9
1948,NED,32,8,2,42
1948,NOR,17,7,7,31
1948,PAN,2,0,0,2
1948,PER,0,1,0,1
1948,POL,1,1,0,2
1948,POR,3,0,2,5
1948,PUR,1,0,0,1
1948,RSA,2,2,2,6
1948,SRI,0,0,1,1
1948,SUI,25,9,30,64
1948,SWE,33,37,18,88
1948,TCH,3,14,20,37
1948,TTO,0,0,1,1
1948,TUR,2,6,4,12
1948,URU,2,0,1,3
1948,USA,41,93,34,168
1948,YUG,0,0,16,16
1952,ARG,2,2,2,6
1952,AUS,11,7,2,20
1952,AUT,4,2,5,11
1952,BEL,0,5,3,8
1952,BRA,2,1,0,3
1952,BUL,1,0,0,1
1952,CAN,1,17,3,21
1952,CHI,0,0,4,4
1952,DEN,5,3,1,9
1952,EGY,1,0,0,1
1952,ESP,0,0,1,1
1952,FIN,31,14,7,52
1952,FRA,18,14,9,41
1952,GBR,26,4,2,32
1952,GER,28,8,16,52
1952,HUN,34,53,17,104
1952,IND,1,14,0,15
1952,IRI,4,0,3,7
1952,IRL,0,0,1,1
1952,ITA,16,18,22,56
1952,JAM,0,5,3,8
1952,JPN,2,1,9,12
1952,KOR,2,0,0,2
1952,LIB,1,0,1,2
1952,LUX,0,1,0,1
1952,MEX,0,0,1,1
1952,NED,0,0,21,21
1952,NOR,6,12,14,32
1952,NZL,2,1,0,3
1952,POL,1,1,2,4
1952,POR,2,0,0,2
1952,ROU,2,1,1,4
1952,RSA,4,2,8,14
1952,SUI,18,2,19,39
1952,SWE,46,23,24,93
1952,TCH,10,11,4,25
1952,TTO,2,0,0,2
1952,TUR,1,2,0,3
1952,URS,19,36,62,117
1952,URU,14,0,0,14
1952,USA,29,87,48,164
1952,VEN,1,0,0,1
1952,YUG,0,4,20,24
1956,ARG,1,0,1,2
1956,AUS,26,28,13,67
1956,AUT,8,5,3,16
1956,BAH,2,0,0,2
1956,BEL,0,0,2,2
1956,BRA,0,1,0,1
1956,BUL,14,1,3,18
1956,CAN,23,5,11,39
1956,CHI,2,0,2,4
1956,DEN,1,1,4,6
1956,FIN,23,8,7,38
1956,FRA,13,7,13,33
1956,GBR,22,8,16,46
1956,GER,24,10,20,54
1956,GRE,1,0,0,1
1956,HUN,16,30,20,66
1956,IND,0,17,0,17
1956,IRI,1,2,2,5
1956,IRL,3,1,1,5
1956,ISL,0,0,1,1
1956,ITA,10,28,17,55
1956,JPN,5,4,16,25
1956,KOR,1,0,1,2
1956,MEX,1,1,0,2
1956,NOR,3,3,1,7
1956,NZL,0,3,0,3
1956,PAK,0,0,14,14
1956,POL,10,1,9,20
1956,ROU,10,6,3,19
1956,RSA,7,0,0,7
1956,SUI,5,6,2,13
1956,SWE,15,16,18,49
1956,TCH,1,1,5,7
1956,TUR,2,3,2,7
1956,URS,61,94,51,206
1956,URU,12,0,0,12
1956,USA,25,63,61,149
1956,YUG,0,0,23,23
1960,ARG,1,0,3,4
1960,AUS,11,11,24,46
1960,AUT,3,2,4,9
1960,BEL,2,0,2,4
1960,BRA,13,0,0,13
1960,BUL,3,1,3,7
1960,CAN,1,3,26,30
1960,DEN,4,2,17,23
1960,ESP,14,0,0,14
1960,ETH,0,1,0,1
1960,FIN,9,6,4,19
1960,FRA,8,1,6,15
1960,GBR,15,2,11,28
1960,GER,23,38,37,98
1960,GHA,0,0,1,1
1960,GRE,0,3,0,3
1960,HUN,37,13,16,66
1960,IND,0,0,13,13
1960,IRI,3,0,1,4
1960,IRQ,1,0,0,1
1960,ITA,35,36,18,89
1960,JPN,12,9,10,31
1960,MAR,0,0,1,1
1960,MEX,1,0,0,1
1960,NED,3,0,2,5
1960,NOR,0,5,6,11
1960,NZL,1,2,0,3
1960,PAK,1,13,0,14
1960,POL,16,4,12,32
1960,POR,0,0,2,2
1960,ROU,11,3,1,15
1960,RSA,2,0,1,3
1960,SGP,0,0,1,1
1960,SUI,6,2,6,14
1960,SWE,5,7,4,16
1960,TCH,11,4,8,23
1960,TPE,0,0,1,1
1960,TUR,0,7,2,9
1960,UAR,1,0,1,2
1960,URS,73,68,70,211
1960,USA,25,100,27,152
1960,VEN,1,0,0,1
1960,WIF,5,0,0,5
1960,YUG,0,16,1,17
1964,ARG,0,0,1,1
1964,AUS,30,8,6,44
1964,AUT,3,5,9,17
1964,BAH,0,2,0,2
1964,BEL,1,2,0,3
1964,BRA,12,0,0,12
1964,BUL,2,3,5,10
1964,CAN,2,6,4,12
1964,CUB,0,0,1,1
1964,DEN,4,7,1,12
1964,ETH,0,1,0,1
1964,FIN,7,6,7,20
1964,FRA,17,4,17,38
1964,GBR,5,6,19,30
1964,GER,53,25,48,126
1964,GHA,1,0,0,1
1964,HUN,7,42,7,56
1964,IND,0,15,0,15
1964,IRI,2,0,0,2
1964,IRL,1,0,0,1
1964,ITA,17,14,30,61
1964,JPN,25,32,5,62
1964,KEN,1,0,0,1
1964,KOR,1,0,2,3
1964,MEX,1,0,0,1
1964,NED,16,6,11,33
1964,NGR,1,0,0,1
1964,NOR,6,3,6,15
1964,NZL,2,4,0,6
1964,PAK,0,0,16,16
1964,PHI,0,0,1,1
1964,POL,23,10,13,46
1964,PRK,0,0,1,1
1964,ROU,10,2,4,16
1964,SUI,1,1,4,6
1964,SWE,9,9,25,43
1964,TCH,29,5,37,71
1964,TTO,5,0,1,6
1964,TUN,1,0,1,2
1964,TUR,1,2,3,6
1964,URS,60,90,71,221
1964,URU,1,0,0,1
1964,USA,42,96,39,177
1964,YUG,2,2,11,15
1968,ARG,2,0,0,2
1968,AUS,11,5,35,51
1968,AUT,7,3,10,20
1968,BEL,2,0,1,3
1968,BRA,3,0,1,4
1968,BUL,3,2,21,26
1968,CAN,22,4,4,30
1968,CMR,0,0,1,1
1968,CUB,0,0,10,10
1968,DEN,6,5,6,17
1968,ETH,0,1,1,2
1968,FIN,6,2,4,12
1968,FRA,12,16,8,36
1968,FRG,23,19,19,61
1968,GBR,5,9,5,19
1968,GDR,21,15,22,58
1968,GRE,1,0,0,1
1968,HUN,29,32,20,81
1968,IND,16,0,0,16
1968,IRI,2,2,1,5
1968,ITA,20,13,8,41
1968,JAM,0,0,1,1
1968,JPN,22,16,25,63
1968,KEN,2,3,7,12
1968,KOR,1,0,1,2
1968,MEX,3,3,3,9
1968,MGL,3,0,1,4
1968,NED,4,9,10,23
1968,NOR,2,15,11,28
1968,NZL,2,5,0,7
1968,PAK,0,13,0,13
1968,POL,30,5,2,37
1968,ROU,11,5,9,25
1968,SUI,17,0,5,22
1968,SWE,7,7,11,25
1968,TCH,16,8,26,50
1968,TPE,1,0,0,1
1968,TUN,1,1,0,2
1968,TUR,0,2,0,2
1968,UGA,1,0,1,2
1968,URS,69,91,69,229
1968,USA,36,100,37,173
1968,VEN,0,1,0,1
1968,YUG,2,13,14,29
1972,ARG,0,0,1,1
1972,AUS,2,11,7,20
1972,AUT,4,1,3,8
1972,BEL,0,0,2,2
1972,BRA,2,0,0,2
1972,BUL,6,6,10,22
1972,CAN,9,0,3,12
1972,COL,2,0,1,3
1972,CUB,18,3,1,22
1972,DEN,0,1,0,1
1972,ESP,1,1,0,2
1972,ETH,2,0,0,2
1972,FIN,7,3,10,20
1972,FRA,17,2,6,25
1972,FRG,43,48,21,112
1972,GBR,12,8,9,29
1972,GDR,69,35,67,171
1972,GHA,1,0,0,1
1972,GRE,0,0,2,2
1972,HUN,25,10,46,81
1972,IND,14,0,0,14
1972,IRI,1,0,2,3
1972,ITA,14,12,8,34
1972,JAM,1,0,0,1
1972,JPN,9,30,20,59
1972,KEN,4,5,3,12
1972,KOR,0,0,1,1
1972,LIB,0,0,1,1
1972,MEX,0,0,1,1
1972,MGL,0,0,1,1
1972,NED,4,7,4,15
1972,NGR,1,0,0,1
1972,NIG,1,0,0,1
1972,NOR,11,4,10,25
1972,NZL,1,9,4,14
1972,PAK,0,0,15,15
1972,POL,11,28,8,47
1972,PRK,13,1,1,15
1972,ROU,27,3,10,40
1972,SUI,7,7,11,25
1972,SWE,10,5,11,26
1972,TCH,25,3,21,49
1972,TUN,0,0,1,1
1972,TUR,0,0,1,1
1972,UGA,0,1,1,2
1972,URS,63,143,53,259
1972,USA,46,72,77,195
1972,YUG,2,15,1,18
1976,AUS,8,0,15,23
1976,AUT,4,2,2,8
1976,BEL,6,0,3,9
1976,BER,1,0,0,1
1976,BRA,3,0,0,3
1976,BUL,18,8,13,39
1976,CAN,15,1,10,26
1976,CUB,14,6,4,24
1976,DEN,5,3,0,8
1976,ESP,0,0,6,6
1976,FIN,1,9,12,22
1976,FRA,9,5,7,21
1976,FRG,55,23,32,110
1976,GBR,11,7,15,33
1976,GDR,56,114,57,227
1976,HUN,35,14,6,55
1976,IRI,1,0,1,2
1976,ITA,5,3,27,35
1976,JAM,0,1,1,2
1976,JPN,10,25,6,41
1976,KOR,15,1,1,17
1976,LIE,2,0,0,2
1976,MEX,1,1,0,2
1976,MGL,0,0,1,1
1976,NED,15,1,4,20
1976,NOR,1,5,10,16
1976,NZL,9,15,1,25
1976,PAK,16,0,0,16
1976,POL,26,18,29,73
1976,POR,0,0,2,2
1976,PRK,0,1,1,2
1976,PUR,1,0,0,1
1976,ROU,23,4,28,55
1976,SUI,8,2,9,19
1976,SWE,2,9,1,12
1976,TCH,9,2,23,34
1976,THA,1,0,0,1
1976,TTO,0,1,0,1
1976,URS,88,152,102,342
1976,USA,41,73,61,175
1976,VEN,0,0,1,1
1976,YUG,3,2,14,19
1980,AUS,5,6,2,13
1980,AUT,4,4,5,13
1980,BEL,0,1,0,1
1980,BRA,5,4,0,9
1980,BUL,39,8,44,91
1980,CAN,1,0,1,2
1980,CUB,5,8,7,20
1980,DEN,2,4,2,8
1980,ESP,3,2,19,24
1980,ETH,2,2,0,4
1980,FIN,11,4,6,21
1980,FRA,7,18,5,30
1980,FRG,6,0,2,8
1980,GBR,24,6,18,48
1980,GDR,73,131,99,303
1980,GRE,4,1,0,5
1980,GUY,1,0,0,1
1980,HUN,40,8,15,63
1980,IND,0,16,0,16
1980,IRL,1,0,2,3
1980,ITA,8,8,24,40
1980,JAM,3,0,0,3
1980,JPN,0,0,1,1
1980,LIB,1,0,0,1
1980,LIE,0,2,2,4
1980,MEX,9,0,1,10
1980,MGL,2,0,2,4
1980,NED,6,1,3,10
1980,NOR,9,1,5,15
1980,POL,22,3,25,50
1980,PRK,2,0,3,5
1980,ROU,46,7,15,68
1980,SUI,3,4,4,11
1980,SWE,29,6,8,43
1980,TAN,0,0,2,2
1980,TCH,17,17,18,52
1980,UGA,0,0,1,1
1980,URS,133,205,158,496
1980,USA,2,24,4,30
1980,VEN,0,0,1,1
1980,YUG,17,13,27,57
1980,ZIM,0,15,0,15
1984,ALG,2,0,0,2
1984,AUS,31,7,14,52
1984,AUT,2,1,1,4
1984,BEL,2,1,2,5
1984,BRA,2,1,33,36
1984,CAN,33,21,37,91
1984,CHN,37,24,13,74
1984,CIV,0,0,1,1
1984,CMR,1,0,0,1
1984,COL,0,0,1,1
1984,DEN,10,0,3,13
1984,DOM,1,0,0,1
1984,EGY,0,0,1,1
1984,ESP,3,2,14,19
1984,FIN,18,8,5,31
1984,FRA,33,20,17,70
1984,FRG,57,33,76,166
1984,GBR,42,11,20,73
1984,GDR,7,13,13,33
1984,GRE,1,0,1,2
1984,IRL,0,0,1,1
1984,ISL,1,0,0,1
1984,ITA,28,31,6,65
1984,JAM,2,0,5,7
1984,JPN,31,10,9,50
1984,KEN,2,1,0,3
1984,KOR,7,6,28,41
1984,LIE,2,0,0,2
1984,MAR,0,2,0,2
1984,MEX,1,2,3,6
1984,NED,14,20,7,41
1984,NGR,4,0,1,5
1984,NOR,7,6,6,19
1984,NZL,6,16,1,23
1984,PAK,0,16,0,16
1984,PER,0,0,1,1
1984,POR,2,1,0,3
1984,PUR,1,0,1,2
1984,ROU,35,40,31,106
1984,SUI,8,2,11,21
1984,SWE,34,10,20,64
1984,SYR,0,0,1,1
1984,TCH,4,0,24,28
1984,THA,0,0,1,1
1984,TPE,1,0,0,1
1984,TUR,3,0,0,3
1984,URS,12,29,15,56
1984,USA,50,190,121,361
1984,VEN,3,0,0,3
1984,YUG,35,47,6,88
1984,ZAM,1,0,0,1
1988,AHO,0,0,1,1
1988,ARG,12,0,1,13
1988,AUS,11,18,6,35
1988,AUT,4,4,5,13
1988,BEL,2,0,0,2
1988,BRA,5,1,17,23
1988,BUL,17,10,14,41
1988,CAN,18,4,7,29
1988,CHI,0,0,1,1
1988,CHN,30,6,16,52
1988,COL,1,0,0,1
1988,CRC,0,0,1,1
1988,DEN,3,3,1,7
1988,DJI,1,0,0,1
1988,ESP,2,1,2,5
1988,FIN,7,8,23,38
1988,FRA,14,13,4,31
1988,FRG,49,36,44,129
1988,GBR,15,22,17,54
1988,GDR,55,89,69,213
1988,GRE,1,0,0,1
1988,HUN,15,20,9,44
1988,INA,0,0,3,3
1988,IRI,0,0,1,1
1988,ISV,0,0,1,1
1988,ITA,13,13,11,37
1988,JAM,0,0,7,7
1988,JPN,14,4,3,21
1988,KEN,2,5,2,9
1988,KOR,12,28,37,77
1988,LIE,1,0,0,1
1988,MAR,2,1,0,3
1988,MEX,2,0,0,2
1988,MGL,1,0,0,1
1988,NED,38,6,8,52
1988,NOR,5,2,26,33
1988,NZL,16,4,4,24
1988,PAK,1,0,0,1
1988,PER,0,0,12,12
1988,PHI,1,0,0,1
1988,POL,10,2,9,21
1988,POR,0,1,0,1
1988,ROU,16,8,34,58
1988,SEN,0,0,1,1
1988,SUI,7,8,13,28
1988,SUR,0,1,0,1
1988,SWE,34,7,5,46
1988,TCH,8,3,5,16
1988,THA,1,0,0,1
1988,TUR,0,1,1,2
1988,URS,111,174,81,366
1988,USA,58,89,67,214
1988,YUG,22,15,32,69
1992,ALG,1,1,0,2
1992,ARG,2,0,0,2
1992,AUS,16,14,27,57
1992,AUT,10,9,16,35
1992,BAH,1,0,0,1
1992,BEL,2,0,1,3
1992,BRA,0,13,1,14
1992,BUL,7,3,7,17
1992,CAN,15,32,33,80
1992,CHN,19,18,48,85
1992,COL,1,0,0,1
1992,CRO,3,0,12,15
1992,CUB,14,42,13,69
1992,DEN,9,3,2,14
1992,ESP,3,48,19,70
1992,EST,2,1,0,3
1992,ETH,2,1,0,3
1992,EUN,81,127,71,279
1992,FIN,8,7,5,20
1992,FRA,44,14,11,69
1992,GBR,39,8,3,50
1992,GER,67,95,74,236
1992,GHA,20,0,0,20
1992,GRE,0,2,0,2
1992,HUN,8,14,23,45
1992,INA,1,2,3,6
1992,IOA,2,0,1,3
1992,IRI,2,0,1,3
1992,IRL,0,1,1,2
1992,ISR,1,0,1,2
1992,ITA,22,25,19,66
1992,JAM,1,0,3,4
1992,JPN,43,6,10,59
1992,KEN,2,2,4,8
1992,KOR,17,33,6,56
1992,LAT,1,0,2,3
1992,LTU,12,1,0,13
1992,LUX,0,0,2,2
1992,MAR,1,1,1,3
1992,MAS,2,0,0,2
1992,MEX,0,0,1,1
1992,MGL,2,0,0,2
1992,NAM,0,0,2,2
1992,NED,10,6,21,37
1992,NGR,4,0,7,11
1992,NOR,6,11,30,47
1992,NZL,5,1,10,16
1992,PAK,16,0,0,16
1992,PER,0,0,1,1
1992,PHI,1,0,0,1
1992,POL,19,5,22,46
1992,PRK,7,4,0,11
1992,PUR,1,0,0,1
1992,QAT,1,0,0,1
1992,ROU,14,8,31,53
1992,RSA,0,0,3,3
1992,SLO,6,0,0,6
1992,SUI,5,3,0,8
1992,SUR,1,0,0,1
1992,SWE,13,2,27,42
1992,TCH,28,4,3,35
1992,THA,1,0,0,1
1992,TPE,0,0,20,20
1992,TUR,2,2,2,6
1992,USA,87,94,57,238
1994,AUS,4,0,0,4
1994,AUT,7,2,3,12
1994,BLR,0,0,2,2
1994,CAN,5,3,29,37
1994,CHN,2,0,1,3
1994,FIN,29,0,1,30
1994,FRA,10,0,1,11
1994,GBR,3,0,0,3
1994,GER,12,18,10,40
1994,ITA,12,14,6,32
1994,JPN,2,3,5,10
1994,KAZ,0,1,2,3
1994,KOR,1,7,1,9
1994,NED,3,0,1,4
1994,NOR,5,8,17,30
1994,RUS,4,19,13,36
1994,SLO,3,0,0,3
1994,SUI,4,4,8,16
1994,SWE,0,23,1,24
1994,UKR,1,1,0,2
1994,USA,5,6,8,19
1994,UZB,0,1,0,1
1996,ALG,1,2,0,3
1996,ARG,1,0,19,20
1996,ARM,0,1,1,2
1996,AUS,84,32,16,132
1996,AUT,2,0,1,3
1996,AZE,0,0,1,1
1996,BAH,0,0,5,5
1996,BDI,0,1,0,1
1996,BEL,2,2,2,6
1996,BLR,16,1,6,23
1996,BRA,43,5,15,63
1996,BUL,6,3,12,21
1996,CAN,12,8,30,50
1996,CHN,17,19,70,106
1996,CRC,0,1,0,1
1996,CRO,0,16,12,28
1996,CUB,10,37,8,55
1996,CZE,4,4,5,13
1996,DEN,1,21,1,23
1996,ECU,0,1,0,1
1996,ESP,22,23,21,66
1996,ETH,1,2,0,3
1996,FIN,1,1,2,4
1996,FRA,20,21,10,51
1996,GBR,9,2,15,26
1996,GEO,2,0,0,2
1996,GER,47,42,35,124
1996,GRE,0,4,4,8
1996,HKG,0,1,0,1
1996,HUN,26,8,9,43
1996,INA,3,2,1,6
1996,IND,1,0,0,1
1996,IRI,1,1,1,3
1996,IRL,1,3,0,4
1996,ISR,1,0,0,1
1996,ITA,28,19,24,71
1996,JAM,12,1,3,16
1996,JPN,13,3,26,42
1996,KAZ,4,3,4,11
1996,KEN,3,1,4,8
1996,KOR,7,10,49,66
1996,LAT,0,0,1,1
1996,LTU,11,0,0,11
1996,MAR,2,0,0,2
1996,MAS,1,0,2,3
1996,MDA,1,0,2,3
1996,MEX,1,0,0,1
1996,MGL,1,0,0,1
1996,MOZ,1,0,0,1
1996,NAM,0,0,2,2
1996,NED,26,38,9,73
1996,NGR,3,17,4,24
1996,NOR,18,2,3,23
1996,NZL,4,3,2,9
1996,PHI,0,0,1,1
1996,POL,7,7,8,22
1996,POR,2,1,0,3
1996,PRK,2,2,1,5
1996,PUR,1,0,0,1
1996,ROU,15,13,10,38
1996,RSA,1,3,1,5
1996,RUS,34,36,45,115
1996,SCG,13,1,12,26
1996,SLO,0,0,2,2
1996,SUI,0,5,6,11
1996,SVK,1,1,1,3
1996,SWE,5,3,23,31
1996,SYR,0,1,0,1
1996,TGA,0,0,1,1
1996,THA,1,1,0,2
1996,TPE,0,0,1,1
1996,TTO,2,0,0,2
1996,TUN,1,0,0,1
1996,TUR,1,4,1,6
1996,UGA,1,0,0,1
1996,UKR,19,10,5,34
1996,USA,52,159,48,259
1996,UZB,1,0,1,2
1996,ZAM,0,0,1,1
1998,AUS,1,0,0,1
1998,AUT,12,3,5,20
1998,BEL,1,0,0,1
1998,BLR,2,0,0,2
1998,BUL,0,1,0,1
1998,CAN,7,14,28,49
1998,CHN,5,0,9,14
1998,CZE,1,21,1,23
1998,DEN,0,0,5,5
1998,FIN,49,2,7,58
1998,FRA,12,2,1,15
1998,GBR,4,0,0,4
1998,GER,10,22,12,44
1998,ITA,5,3,9,17
1998,JPN,4,8,1,13
1998,KAZ,2,0,0,2
1998,KOR,2,6,4,12
1998,NED,2,5,4,11
1998,NOR,12,13,15,40
1998,RUS,6,14,32,52
1998,SUI,3,6,5,14
1998,SWE,5,0,2,7
1998,UKR,0,0,1,1
1998,USA,5,25,4,34
2000,ALG,3,1,1,5
2000,ARG,3,0,17,20
2000,ARM,1,0,0,1
2000,AUS,54,60,69,183
2000,AUT,0,3,1,4
2000,AZE,1,2,0,3
2000,BAH,5,6,0,11
2000,BAR,1,0,0,1
2000,BEL,4,0,3,7
2000,BLR,11,3,8,22
2000,BRA,36,0,12,48
2000,BUL,2,5,6,13
2000,CAN,23,4,4,31
2000,CHI,17,0,0,17
2000,CHN,17,39,23,79
2000,CMR,0,18,0,18
2000,COL,0,1,0,1
2000,CRC,2,0,0,2
2000,CRO,9,1,0,10
2000,CUB,12,18,35,65
2000,CZE,4,2,3,9
2000,DEN,4,18,3,25
2000,ESP,20,3,19,42
2000,EST,2,1,0,3
2000,ETH,3,4,1,8
2000,FIN,1,3,1,5
2000,FRA,14,22,30,66
2000,GBR,12,22,20,54
2000,GEO,6,0,0,6
2000,GER,64,31,23,118
2000,GRE,8,4,6,18
2000,HUN,4,25,24,53
2000,INA,2,2,4,8
2000,IND,1,0,0,1
2000,IRI,1,3,0,4
2000,IRL,0,0,1,1
2000,ISL,1,0,0,1
2000,ISR,1,0,0,1
2000,ITA,29,22,14,65
2000,JAM,3,0,20,23
2000,JPN,8,5,31,44
2000,KAZ,0,3,4,7
2000,KEN,2,2,3,7
2000,KGZ,1,0,0,1
2000,KOR,35,12,26,73
2000,KSA,1,0,1,2
2000,KUW,1,0,0,1
2000,LAT,1,1,1,3
2000,LTU,15,2,0,17
2000,MAR,4,0,1,5
2000,MDA,1,0,1,2
2000,MEX,3,1,2,6
2000,MKD,1,0,0,1
2000,MOZ,0,1,0,1
2000,NED,23,27,29,79
2000,NGR,0,6,2,8
2000,NOR,19,20,4,43
2000,NZL,3,1,0,4
2000,POL,7,7,10,24
2000,POR,2,0,0,2
2000,PRK,3,0,1,4
2000,QAT,1,0,0,1
2000,ROU,13,27,6,46
2000,RSA,3,0,2,5
2000,RUS,54,66,67,187
2000,SCG,13,11,1,25
2000,SLO,0,3,0,3
2000,SRI,0,0,1,1
2000,SUI,2,1,11,14
2000,SVK,1,2,3,6
2000,SWE,8,4,20,32
2000,THA,2,1,0,3
2000,TPE,4,0,1,5
2000,TTO,1,0,1,2
2000,TUR,2,3,0,5
2000,UKR,12,3,20,35
2000,URU,0,0,1,1
2000,USA,51,130,61,242
2000,UZB,2,1,1,4
2000,VIE,0,0,1,1
2002,AUS,0,2,0,2
2002,AUT,13,3,4,20
2002,BLR,1,0,0,1
2002,BUL,2,0,1,3
2002,CAN,15,52,7,74
2002,CHN,9,2,5,16
2002,CRO,0,3,1,4
2002,CZE,0,1,2,3
2002,EST,1,1,1,3
2002,FIN,1,7,5,13
2002,FRA,5,5,5,15
2002,GBR,1,5,0,6
2002,GER,12,26,23,61
2002,ITA,6,4,11,21
2002,JPN,1,0,1,2
2002,KOR,0,5,2,7
2002,NED,0,3,5,8
2002,NOR,7,23,11,41
2002,POL,1,0,1,2
2002,RUS,27,6,5,38
2002,SLO,4,0,0,4
2002,SUI,14,3,7,24
2002,SWE,24,0,2,26
2002,USA,15,11,58,84
2004,ARG,21,28,0,49
2004,AUS,31,49,77,157
2004,AUT,1,3,4,8
2004,AZE,4,1,0,5
2004,BAH,1,1,0,2
2004,BEL,2,1,0,3
2004,BLR,8,2,5,15
2004,BRA,3,18,19,40
2004,BUL,14,2,1,17
2004,CAN,4,3,10,17
2004,CHI,1,3,0,4
2004,CHN,15,52,27,94
2004,CMR,0,1,0,1
2004,COL,2,0,0,2
2004,CRO,3,15,3,21
2004,CUB,22,32,8,62
2004,CZE,6,1,6,13
2004,DEN,9,19,1,29
2004,DOM,0,1,0,1
2004,EGY,3,1,1,5
2004,ERI,1,0,0,1
2004,ESP,9,4,17,30
2004,EST,2,0,1,3
2004,ETH,2,2,3,7
2004,FIN,0,0,2,2
2004,FRA,22,21,10,53
2004,GBR,15,17,25,57
2004,GEO,0,2,2,4
2004,GER,63,41,45,149
2004,GRE,5,8,18,31
2004,HKG,0,0,2,2
2004,HUN,4,24,12,40
2004,INA,3,1,1,5
2004,IND,0,0,1,1
2004,IRI,2,2,2,6
2004,ISR,1,1,0,2
2004,ITA,39,24,41,104
2004,JAM,6,6,1,13
2004,JPN,52,21,20,93
2004,KAZ,3,1,4,8
2004,KEN,2,1,4,7
2004,KOR,10,14,28,52
2004,LAT,0,0,4,4
2004,LTU,0,1,2,3
2004,MAR,0,2,1,3
2004,MEX,1,0,3,4
2004,MGL,1,0,0,1
2004,NED,22,4,51,77
2004,NGR,8,0,0,8
2004,NOR,2,5,0,7
2004,NZL,0,4,2,6
2004,PAR,0,0,17,17
2004,POL,6,4,2,12
2004,POR,1,0,2,3
2004,PRK,1,0,4,5
2004,ROU,11,23,5,39
2004,RSA,3,4,3,10
2004,RUS,95,48,46,189
2004,SCG,0,0,13,13
2004,SLO,3,0,2,5
2004,SUI,4,1,2,7
2004,SVK,5,3,2,10
2004,SWE,2,5,5,12
2004,SYR,1,0,0,1
2004,THA,4,3,1,8
2004,TPE,3,2,4,9
2004,TTO,1,0,0,1
2004,TUR,5,3,3,11
2004,UAE,0,1,0,1
2004,UKR,31,8,8,47
2004,USA,71,117,75,263
2004,UZB,2,2,1,5
2004,VEN,2,0,0,2
2004,ZIM,1,1,1,3
2006,AUS,1,1,0,2
2006,AUT,7,16,7,30
2006,BLR,0,0,1,1
2006,BUL,0,0,1,1
2006,CAN,11,30,28,69
2006,CHN,6,2,5,13
2006,CRO,0,1,2,3
2006,CZE,24,1,2,27
2006,EST,0,3,0,3
2006,FIN,7,0,34,41
2006,FRA,10,3,2,15
2006,GBR,0,0,1,1
2006,GER,6,23,25,54
2006,ITA,14,11,0,25
2006,JPN,0,1,0,1
2006,KOR,2,14,3,19
2006,LAT,1,0,0,1
2006,NED,8,3,2,13
2006,NOR,12,2,9,23
2006,POL,1,0,1,2
2006,RUS,13,16,12,41
2006,SUI,9,5,7,21
2006,SVK,0,0,1,1
2006,SWE,8,35,21,64
2006,UKR,3,0,0,3
2006,USA,32,9,11,52
2008,AFG,1,0,0,1
2008,ALG,1,0,1,2
2008,ARG,31,20,0,51
2008,ARM,6,0,0,6
2008,AUS,76,31,42,149
2008,AUT,2,0,1,3
2008,AZE,4,1,2,7
2008,BAH,1,0,6,7
2008,BEL,0,1,4,5
2008,BLR,16,8,5,29
2008,BRA,30,14,34,78
2008,BUL,3,1,1,5
2008,CAN,11,11,13,35
2008,CHI,0,0,1,1
2008,CHN,57,74,53,184
2008,CMR,0,1,0,1
2008,COL,1,0,1,2
2008,CRO,3,0,2,5
2008,CUB,11,2,34,47
2008,CZE,0,3,4,7
2008,DEN,6,6,7,19
2008,DOM,0,1,1,2
2008,ECU,0,0,1,1
2008,EGY,1,0,0,1
2008,ESP,16,7,47,70
2008,EST,0,1,2,3
2008,ETH,2,4,1,7
2008,FIN,2,1,2,5
2008,FRA,28,25,24,77
2008,GBR,25,31,25,81
2008,GEO,3,3,0,6
2008,GER,41,42,16,99
2008,GRE,4,0,3,7
2008,HUN,3,16,8,27
2008,INA,3,2,2,7
2008,IND,2,1,0,3
2008,IRI,1,1,0,2
2008,IRL,2,0,1,3
2008,ISL,0,0,14,14
2008,ISR,1,0,0,1
2008,ITA,20,8,14,42
2008,JAM,6,5,3,14
2008,JPN,13,23,15,51
2008,KAZ,7,2,4,13
2008,KEN,5,6,4,15
2008,KGZ,1,0,1,2
2008,KOR,26,41,11,78
2008,LAT,1,1,1,3
2008,LTU,3,0,2,5
2008,MAR,1,0,1,2
2008,MAS,0,0,1,1
2008,MDA,1,0,0,1
2008,MEX,2,2,0,4
2008,MGL,0,2,2,4
2008,MRI,1,0,0,1
2008,NED,4,39,18,61
2008,NGR,7,0,16,23
2008,NOR,1,16,5,22
2008,NZL,9,4,2,15
2008,PAN,0,1,0,1
2008,POL,1,6,13,20
2008,POR,0,1,1,2
2008,PRK,3,2,1,6
2008,ROU,16,5,1,22
2008,RSA,0,0,1,1
2008,RUS,53,43,46,142
2008,SGP,0,0,3,3
2008,SLO,2,1,2,5
2008,SRB,14,0,1,15
2008,SUD,0,0,1,1
2008,SUI,7,3,1,11
2008,SVK,1,4,5,10
2008,SWE,2,0,5,7
2008,THA,0,2,2,4
2008,TJK,1,0,1,2
2008,TOG,1,0,0,1
2008,TPE,4,0,0,4
2008,TTO,0,5,1,6
2008,TUN,0,1,0,1
2008,TUR,3,1,3,7
2008,UKR,16,10,5,31
2008,USA,80,127,110,317
2008,UZB,3,1,2,6
2008,VEN,1,0,0,1
2008,VIE,0,0,1,1
2008,ZIM,0,1,3,4
2010,AUS,0,2,1,3
2010,AUT,6,11,9,26
2010,BLR,1,1,1,3
2010,CAN,8,67,15,90
2010,CHN,7,9,3,19
2010,CRO,1,0,2,3
2010,CZE,7,2,0,9
2010,EST,0,0,1,1
2010,FIN,46,0,1,47
2010,FRA,6,2,6,14
2010,GBR,0,1,0,1
2010,GER,15,15,24,54
2010,ITA,3,1,1,5
2010,JPN,2,0,5,7
2010,KAZ,0,0,1,1
2010,KOR,2,6,10,18
2010,LAT,0,0,3,3
2010,NED,6,4,1,11
2010,NOR,9,16,14,39
2010,POL,4,1,3,8
2010,RUS,14,6,5,25
2010,SLO,1,0,2,3
2010,SUI,6,6,0,12
2010,SVK,1,1,1,3
2010,SWE,4,11,3,18
2010,USA,22,12,63,97
2012,AFG,1,0,0,1
2012,ALG,0,1,0,1
2012,ARG,3,1,15,19
2012,ARM,2,0,1,3
2012,AUS,59,18,37,114
2012,AZE,6,2,2,10
2012,BAH,0,4,0,4
2012,BEL,2,0,1,3
2012,BLR,8,3,12,23
2012,BOT,0,0,1,1
2012,BRA,11,14,34,59
2012,BRN,1,0,0,1
2012,BUL,1,0,1,2
2012,CAN,33,1,21,55
2012,CHN,29,56,40,125
2012,COL,4,1,3,8
2012,CRO,16,15,4,35
2012,CUB,6,5,3,14
2012,CYP,0,0,1,1
2012,CZE,6,4,4,14
2012,DEN,8,3,5,16
2012,DOM,0,1,1,2
2012,EGY,0,0,2,2
2012,ESP,25,5,33,63
2012,EST,1,0,1,2
2012,ETH,3,3,1,7
2012,FIN,4,0,1,5
2012,FRA,22,30,30,82
2012,GAB,0,0,1,1
2012,GBR,48,48,30,126
2012,GEO,3,1,3,7
2012,GER,22,45,27,94
2012,GRE,3,0,0,3
2012,GRN,0,1,0,1
2012,GUA,0,0,1,1
2012,HKG,1,0,0,1
2012,HUN,6,12,8,26
2012,INA,1,0,1,2
2012,IND,4,0,2,6
2012,IRI,3,4,5,12
2012,IRL,3,1,1,5
2012,ITA,30,16,22,68
2012,JAM,8,8,9,25
2012,JPN,33,7,44,84
2012,KAZ,5,7,1,13
2012,KEN,5,2,4,11
2012,KOR,30,18,13,61
2012,KSA,4,0,0,4
2012,KUW,1,0,0,1
2012,LAT,2,1,0,3
2012,LTU,2,2,1,5
2012,MAR,1,0,0,1
2012,MAS,1,0,1,2
2012,MDA,2,0,0,2
2012,MEX,3,16,5,24
2012,MGL,3,0,2,5
2012,MNE,0,0,14,14
2012,NED,19,21,29,69
2012,NOR,1,15,1,17
2012,NZL,15,9,3,27
2012,POL,8,2,2,12
2012,POR,0,0,2,2
2012,PRK,2,4,0,6
2012,PUR,1,0,1,2
2012,QAT,2,0,0,2
2012,ROU,6,2,8,16
2012,RSA,1,6,2,9
2012,RUS,51,50,39,140
2012,SGP,4,0,0,4
2012,SLO,3,1,1,5
2012,SRB,14,1,1,16
2012,SUI,0,2,2,4
2012,SVK,4,0,1,5
2012,SWE,3,2,17,22
2012,THA,1,0,2,3
2012,TJK,1,0,0,1
2012,TPE,1,0,1,2
2012,TTO,5,1,4,10
2012,TUN,1,1,1,3
2012,TUR,1,2,2,5
2012,UGA,0,1,0,1
2012,UKR,12,9,5,26
2012,USA,46,145,57,248
2012,UZB,2,1,0,3
2012,VEN,0,1,0,1
2014,AUS,1,0,2,3
2014,AUT,11,4,12,27
2014,BLR,1,5,0,6
2014,CAN,5,59,22,86
2014,CHN,5,3,4,12
2014,CRO,0,0,1,1
2014,CZE,2,2,7,11
2014,FIN,24,2,7,33
2014,FRA,10,4,4,18
2014,GBR,5,1,4,10
2014,GER,9,15,12,36
2014,ITA,12,0,2,14
2014,JPN,6,1,4,11
2014,KAZ,1,0,0,1
2014,KOR,2,7,5,14
2014,LAT,6,0,5,11
2014,NED,9,13,7,29
2014,NOR,13,18,5,36
2014,POL,3,4,4,11
2014,RUS,13,33,22,68
2014,SLO,4,2,2,8
2014,SUI,20,6,4,30
2014,SVK,0,1,0,1
2014,SWE,11,8,32,51
2014,UKR,1,4,0,5
2014,USA,24,10,30,64
2016,ALG,0,0,2,2
2016,ARG,0,21,1,22
2016,ARM,0,1,3,4
2016,AUS,25,23,34,82
2016,AUT,2,0,0,2
2016,AZE,10,1,7,18
2016,BAH,5,1,0,6
2016,BDI,0,0,1,1
2016,BEL,2,2,17,21
2016,BLR,7,1,4,12
2016,BRA,6,36,8,50
2016,BRN,0,1,1,2
2016,BUL,6,0,1,7
2016,CAN,61,4,4,69
2016,CHN,37,46,30,113
2016,CIV,1,1,0,2
2016,COL,3,3,2,8
2016,CRO,2,7,15,24
2016,CUB,4,5,2,11
2016,CZE,12,1,2,15
2016,DEN,16,15,10,41
2016,DOM,1,0,0,1
2016,EGY,3,0,0,3
2016,ESP,17,9,19,45
2016,EST,4,0,0,4
2016,ETH,5,1,2,8
2016,FIJ,0,13,0,13
2016,FIN,1,0,0,1
2016,FRA,21,20,55,96
2016,GBR,26,64,55,145
2016,GEO,4,2,1,7
2016,GER,67,49,43,159
2016,GRE,3,3,1,7
2016,GRN,0,0,1,1
2016,HUN,7,12,3,22
2016,INA,0,2,2,4
2016,IND,1,0,1,2
2016,IOA,1,1,0,2
2016,IRI,4,3,1,8
2016,IRL,0,0,3,3
2016,ISR,2,0,0,2
2016,ITA,24,8,40,72
2016,JAM,2,11,17,30
2016,JOR,0,1,0,1
2016,JPN,34,17,13,64
2016,KAZ,10,3,5,18
2016,KEN,1,6,6,13
2016,KOR,10,13,3,26
2016,KOS,0,1,0,1
2016,LTU,5,0,2,7
2016,MAR,1,0,0,1
2016,MAS,1,0,7,8
2016,MEX,2,0,3,5
2016,MGL,1,0,1,2
2016,NED,13,9,25,47
2016,NGR,18,0,0,18
2016,NIG,0,0,1,1
2016,NOR,19,0,0,19
2016,NZL,5,6,25,36
2016,PHI,0,0,1,1
2016,POL,10,3,3,16
2016,POR,1,0,0,1
2016,PRK,2,2,3,7
2016,PUR,0,1,0,1
2016,QAT,0,0,1,1
2016,ROU,10,4,2,16
2016,RSA,14,2,7,23
2016,RUS,35,52,28,115
2016,SGP,0,1,0,1
2016,SLO,1,1,2,4
2016,SRB,13,14,27,54
2016,SUI,2,6,3,11
2016,SVK,0,3,5,8
2016,SWE,3,2,23,28
2016,THA,2,2,2,6
2016,TJK,0,1,0,1
2016,TPE,4,1,0,5
2016,TTO,1,0,0,1
2016,TUN,3,0,0,3
2016,TUR,4,1,3,8
2016,UAE,1,0,0,1
2016,UKR,5,2,8,15
2016,USA,71,139,54,264
2016,UZB,7,4,2,13
2016,VEN,2,0,1,3
2016,VIE,0,1,1,2
